Level of Ed.,ISCED,Age,Total,Male,Female
Total education ceased and not ceased,NA,15 years,61643,31483,30160
Total education ceased and not ceased,NA,16 years,60989,31183,29806
Total education ceased and not ceased,NA,17 years,61318,31540,29778
Total education ceased and not ceased,NA,18 years,61294,31383,29911
Total education ceased and not ceased,NA,19 years,57572,29319,28253
Total education ceased and not ceased,NA,20 years,56337,28508,27829
Total education ceased and not ceased,NA,21 years,54397,27407,26990
Total education ceased and not ceased,NA,22 years,54352,27326,27026
Total education ceased and not ceased,NA,23 years,53935,27272,26663
Total education ceased and not ceased,NA,24 years,54615,27071,27544
Total education ceased and not ceased,NA,25 years,57278,28794,28484
Total education ceased and not ceased,NA,26 years,56257,27683,28574
Total education ceased and not ceased,NA,27 years,61652,30239,31413
Total education ceased and not ceased,NA,28 years,59456,28452,31004
Total education ceased and not ceased,NA,29 years,62792,30054,32738
Total education ceased and not ceased,NA,30 years,68347,32752,35595
Total education ceased and not ceased,NA,31 years,68334,32801,35533
Total education ceased and not ceased,NA,32 years,71772,34210,37562
Total education ceased and not ceased,NA,33 years,75704,35990,39714
Total education ceased and not ceased,NA,34 years,77818,37426,40392
Total education ceased and not ceased,NA,35 years,81545,39840,41705
Total education ceased and not ceased,NA,36 years,83196,40892,42304
Total education ceased and not ceased,NA,37 years,77184,37494,39690
Total education ceased and not ceased,NA,38 years,74681,36818,37863
Total education ceased and not ceased,NA,39 years,72815,36001,36814
Total education ceased and not ceased,NA,40 years,73414,36521,36893
Total education ceased and not ceased,NA,41 years,71974,35674,36300
Total education ceased and not ceased,NA,42 years,71172,35307,35865
Total education ceased and not ceased,NA,43 years,71288,35450,35838
Total education ceased and not ceased,NA,44 years,69612,34530,35082
Total education ceased and not ceased,NA,45 years,70457,35243,35214
Total education ceased and not ceased,NA,46 years,67208,33525,33683
Total education ceased and not ceased,NA,47 years,63640,31932,31708
Total education ceased and not ceased,NA,48 years,62946,31315,31631
Total education ceased and not ceased,NA,49 years,61859,30809,31050
Total education ceased and not ceased,NA,50 years,61988,30765,31223
Total education ceased and not ceased,NA,51 years,61798,30446,31352
Total education ceased and not ceased,NA,52 years,60183,29603,30580
Total education ceased and not ceased,NA,53 years,58907,29032,29875
Total education ceased and not ceased,NA,54 years,57059,28366,28693
Total education ceased and not ceased,NA,55 years,57256,28324,28932
Total education ceased and not ceased,NA,56 years,54907,27045,27862
Total education ceased and not ceased,NA,57 years,54459,27175,27284
Total education ceased and not ceased,NA,58 years,52428,25894,26534
Total education ceased and not ceased,NA,59 years,51052,25420,25632
Total education ceased and not ceased,NA,60 years,49865,24802,25063
Total education ceased and not ceased,NA,61 years,49245,24435,24810
Total education ceased and not ceased,NA,62 years,47300,23536,23764
Total education ceased and not ceased,NA,63 years,47402,23523,23879
Total education ceased and not ceased,NA,64 years,45044,22402,22642
Total education ceased and not ceased,NA,65 years,44156,22120,22036
Total education ceased and not ceased,NA,66 years,43546,21361,22185
Total education ceased and not ceased,NA,67 years,42442,21074,21368
Total education ceased and not ceased,NA,68 years,41389,20651,20738
Total education ceased and not ceased,NA,69 years,39703,19755,19948
Total education ceased and not ceased,NA,70 years,37821,18689,19132
Total education ceased and not ceased,NA,71 years,34612,16991,17621
Total education ceased and not ceased,NA,72 years,32430,15919,16511
Total education ceased and not ceased,NA,73 years,30219,14611,15608
Total education ceased and not ceased,NA,74 years,27190,13291,13899
Total education ceased and not ceased,NA,75 years,25449,12142,13307
Total education ceased and not ceased,NA,76 years,24710,11755,12955
Total education ceased and not ceased,NA,77 years,23342,10901,12441
Total education ceased and not ceased,NA,78 years,21489,9955,11534
Total education ceased and not ceased,NA,79 years,20477,9364,11113
Total education ceased and not ceased,NA,80 years,19287,8679,10608
Total education ceased and not ceased,NA,81 years,17821,7846,9975
Total education ceased and not ceased,NA,82 years,16339,7067,9272
Total education ceased and not ceased,NA,83 years,14484,6202,8282
Total education ceased and not ceased,NA,84 years,13106,5402,7704
Total education ceased and not ceased,NA,85 years and over,67555,23062,44493
No formal education,0,15 years,24,14,10
No formal education,0,16 years,41,20,21
No formal education,0,17 years,68,52,16
No formal education,0,18 years,142,88,54
No formal education,0,19 years,199,118,81
No formal education,0,20 years,224,150,74
No formal education,0,21 years,238,150,88
No formal education,0,22 years,255,157,98
No formal education,0,23 years,261,163,98
No formal education,0,24 years,254,132,122
No formal education,0,25 years,310,174,136
No formal education,0,26 years,341,207,134
No formal education,0,27 years,329,194,135
No formal education,0,28 years,356,221,135
No formal education,0,29 years,381,231,150
No formal education,0,30 years,390,216,174
No formal education,0,31 years,446,249,197
No formal education,0,32 years,448,244,204
No formal education,0,33 years,504,296,208
No formal education,0,34 years,579,345,234
No formal education,0,35 years,571,342,229
No formal education,0,36 years,553,333,220
No formal education,0,37 years,565,335,230
No formal education,0,38 years,529,313,216
No formal education,0,39 years,533,318,215
No formal education,0,40 years,580,346,234
No formal education,0,41 years,639,379,260
No formal education,0,42 years,646,372,274
No formal education,0,43 years,696,417,279
No formal education,0,44 years,699,422,277
No formal education,0,45 years,667,400,267
No formal education,0,46 years,730,430,300
No formal education,0,47 years,724,441,283
No formal education,0,48 years,749,416,333
No formal education,0,49 years,766,436,330
No formal education,0,50 years,786,460,326
No formal education,0,51 years,881,502,379
No formal education,0,52 years,881,500,381
No formal education,0,53 years,874,494,380
No formal education,0,54 years,890,509,381
No formal education,0,55 years,889,475,414
No formal education,0,56 years,909,507,402
No formal education,0,57 years,903,496,407
No formal education,0,58 years,939,532,407
No formal education,0,59 years,998,525,473
No formal education,0,60 years,982,528,454
No formal education,0,61 years,1063,584,479
No formal education,0,62 years,1008,535,473
No formal education,0,63 years,1150,612,538
No formal education,0,64 years,1085,607,478
No formal education,0,65 years,1234,699,535
No formal education,0,66 years,1180,629,551
No formal education,0,67 years,1245,666,579
No formal education,0,68 years,1187,657,530
No formal education,0,69 years,1212,662,550
No formal education,0,70 years,1162,638,524
No formal education,0,71 years,1003,544,459
No formal education,0,72 years,1048,558,490
No formal education,0,73 years,1026,543,483
No formal education,0,74 years,967,524,443
No formal education,0,75 years,884,467,417
No formal education,0,76 years,862,475,387
No formal education,0,77 years,960,509,451
No formal education,0,78 years,824,418,406
No formal education,0,79 years,815,385,430
No formal education,0,80 years,793,383,410
No formal education,0,81 years,805,365,440
No formal education,0,82 years,738,354,384
No formal education,0,83 years,642,280,362
No formal education,0,84 years,530,260,270
No formal education,0,85 years and over,3422,1293,2129
Primary,1,15 years,113,74,39
Primary,1,16 years,206,138,68
Primary,1,17 years,265,172,93
Primary,1,18 years,448,289,159
Primary,1,19 years,559,362,197
Primary,1,20 years,577,365,212
Primary,1,21 years,634,400,234
Primary,1,22 years,688,410,278
Primary,1,23 years,636,368,268
Primary,1,24 years,752,432,320
Primary,1,25 years,895,539,356
Primary,1,26 years,855,480,375
Primary,1,27 years,1038,607,431
Primary,1,28 years,1118,648,470
Primary,1,29 years,1224,691,533
Primary,1,30 years,1384,785,599
Primary,1,31 years,1536,894,642
Primary,1,32 years,1573,903,670
Primary,1,33 years,1652,956,696
Primary,1,34 years,1764,1020,744
Primary,1,35 years,1844,1080,764
Primary,1,36 years,1984,1189,795
Primary,1,37 years,1762,1051,711
Primary,1,38 years,1789,1096,693
Primary,1,39 years,1751,1082,669
Primary,1,40 years,1981,1190,791
Primary,1,41 years,2152,1296,856
Primary,1,42 years,2117,1318,799
Primary,1,43 years,2331,1403,928
Primary,1,44 years,2376,1427,949
Primary,1,45 years,2442,1502,940
Primary,1,46 years,2442,1377,1065
Primary,1,47 years,2373,1423,950
Primary,1,48 years,2590,1513,1077
Primary,1,49 years,2748,1600,1148
Primary,1,50 years,2933,1671,1262
Primary,1,51 years,3310,1883,1427
Primary,1,52 years,3476,1948,1528
Primary,1,53 years,3654,1998,1656
Primary,1,54 years,3671,2037,1634
Primary,1,55 years,4110,2239,1871
Primary,1,56 years,4286,2346,1940
Primary,1,57 years,4758,2542,2216
Primary,1,58 years,5447,2775,2672
Primary,1,59 years,6021,3148,2873
Primary,1,60 years,6223,3380,2843
Primary,1,61 years,7247,3841,3406
Primary,1,62 years,7727,4035,3692
Primary,1,63 years,9275,4929,4346
Primary,1,64 years,9718,5216,4502
Primary,1,65 years,10529,5693,4836
Primary,1,66 years,11034,5894,5140
Primary,1,67 years,11558,6234,5324
Primary,1,68 years,11775,6376,5399
Primary,1,69 years,11426,6316,5110
Primary,1,70 years,11298,6161,5137
Primary,1,71 years,10517,5697,4820
Primary,1,72 years,10010,5407,4603
Primary,1,73 years,9621,5135,4486
Primary,1,74 years,8726,4633,4093
Primary,1,75 years,8453,4483,3970
Primary,1,76 years,8565,4434,4131
Primary,1,77 years,7946,4060,3886
Primary,1,78 years,7500,3814,3686
Primary,1,79 years,7357,3693,3664
Primary,1,80 years,6816,3355,3461
Primary,1,81 years,6346,3000,3346
Primary,1,82 years,6073,2874,3199
Primary,1,83 years,5524,2550,2974
Primary,1,84 years,5001,2202,2799
Primary,1,85 years and over,25754,9524,16230
Lower secondary,2,15 years,114,72,42
Lower secondary,2,16 years,491,319,172
Lower secondary,2,17 years,1055,691,364
Lower secondary,2,18 years,1704,1093,611
Lower secondary,2,19 years,2013,1310,703
Lower secondary,2,20 years,1944,1240,704
Lower secondary,2,21 years,2059,1281,778
Lower secondary,2,22 years,2089,1342,747
Lower secondary,2,23 years,2337,1478,859
Lower secondary,2,24 years,2531,1607,924
Lower secondary,2,25 years,3014,2016,998
Lower secondary,2,26 years,3298,2151,1147
Lower secondary,2,27 years,3365,2228,1137
Lower secondary,2,28 years,3543,2271,1272
Lower secondary,2,29 years,3889,2551,1338
Lower secondary,2,30 years,4096,2641,1455
Lower secondary,2,31 years,4384,2747,1637
Lower secondary,2,32 years,4796,3079,1717
Lower secondary,2,33 years,5090,3178,1912
Lower secondary,2,34 years,5377,3432,1945
Lower secondary,2,35 years,5716,3642,2074
Lower secondary,2,36 years,6102,3820,2282
Lower secondary,2,37 years,5938,3755,2183
Lower secondary,2,38 years,5783,3718,2065
Lower secondary,2,39 years,5782,3598,2184
Lower secondary,2,40 years,6283,3848,2435
Lower secondary,2,41 years,7012,4235,2777
Lower secondary,2,42 years,7896,4886,3010
Lower secondary,2,43 years,8785,5339,3446
Lower secondary,2,44 years,9350,5567,3783
Lower secondary,2,45 years,9782,5791,3991
Lower secondary,2,46 years,10090,5905,4185
Lower secondary,2,47 years,10255,6054,4201
Lower secondary,2,48 years,10634,6385,4249
Lower secondary,2,49 years,10614,6363,4251
Lower secondary,2,50 years,10925,6436,4489
Lower secondary,2,51 years,11672,6808,4864
Lower secondary,2,52 years,12064,7082,4982
Lower secondary,2,53 years,12160,7043,5117
Lower secondary,2,54 years,12277,7055,5222
Lower secondary,2,55 years,12134,6828,5306
Lower secondary,2,56 years,11502,6436,5066
Lower secondary,2,57 years,11261,6192,5069
Lower secondary,2,58 years,11174,6186,4988
Lower secondary,2,59 years,11058,5967,5091
Lower secondary,2,60 years,10791,5648,5143
Lower secondary,2,61 years,10610,5440,5170
Lower secondary,2,62 years,10063,5138,4925
Lower secondary,2,63 years,9336,4557,4779
Lower secondary,2,64 years,8509,4078,4431
Lower secondary,2,65 years,8163,3748,4415
Lower secondary,2,66 years,8144,3591,4553
Lower secondary,2,67 years,7599,3303,4296
Lower secondary,2,68 years,7395,3174,4221
Lower secondary,2,69 years,6966,2927,4039
Lower secondary,2,70 years,6729,2787,3942
Lower secondary,2,71 years,5888,2439,3449
Lower secondary,2,72 years,5540,2313,3227
Lower secondary,2,73 years,5125,2055,3070
Lower secondary,2,74 years,4491,1846,2645
Lower secondary,2,75 years,4085,1593,2492
Lower secondary,2,76 years,3919,1549,2370
Lower secondary,2,77 years,3752,1402,2350
Lower secondary,2,78 years,3517,1346,2171
Lower secondary,2,79 years,3274,1194,2080
Lower secondary,2,80 years,3076,1149,1927
Lower secondary,2,81 years,2794,1021,1773
Lower secondary,2,82 years,2551,923,1628
Lower secondary,2,83 years,2200,794,1406
Lower secondary,2,84 years,1996,687,1309
Lower secondary,2,85 years and over,9815,2760,7055
Upper secondary,3,15 years,0,0,0
Upper secondary,3,16 years,125,79,46
Upper secondary,3,17 years,694,412,282
Upper secondary,3,18 years,4254,2605,1649
Upper secondary,3,19 years,8085,4917,3168
Upper secondary,3,20 years,8826,5346,3480
Upper secondary,3,21 years,8792,5321,3471
Upper secondary,3,22 years,8852,5271,3581
Upper secondary,3,23 years,8794,5281,3513
Upper secondary,3,24 years,8883,5222,3661
Upper secondary,3,25 years,8883,5227,3656
Upper secondary,3,26 years,8647,4843,3804
Upper secondary,3,27 years,8476,4597,3879
Upper secondary,3,28 years,9108,4785,4323
Upper secondary,3,29 years,9477,4940,4537
Upper secondary,3,30 years,9480,4907,4573
Upper secondary,3,31 years,9638,5030,4608
Upper secondary,3,32 years,9783,5141,4642
Upper secondary,3,33 years,10241,5106,5135
Upper secondary,3,34 years,10691,5332,5359
Upper secondary,3,35 years,11297,5814,5483
Upper secondary,3,36 years,11317,5750,5567
Upper secondary,3,37 years,11187,5716,5471
Upper secondary,3,38 years,11050,5743,5307
Upper secondary,3,39 years,11123,5862,5261
Upper secondary,3,40 years,11011,5700,5311
Upper secondary,3,41 years,11054,5558,5496
Upper secondary,3,42 years,10637,5187,5450
Upper secondary,3,43 years,11073,5244,5829
Upper secondary,3,44 years,11604,5491,6113
Upper secondary,3,45 years,11782,5466,6316
Upper secondary,3,46 years,12040,5556,6484
Upper secondary,3,47 years,11851,5390,6461
Upper secondary,3,48 years,12280,5514,6766
Upper secondary,3,49 years,12239,5456,6783
Upper secondary,3,50 years,12285,5242,7043
Upper secondary,3,51 years,11998,5022,6976
Upper secondary,3,52 years,11855,4830,7025
Upper secondary,3,53 years,11882,4680,7202
Upper secondary,3,54 years,12035,4968,7067
Upper secondary,3,55 years,12389,5202,7187
Upper secondary,3,56 years,11964,5132,6832
Upper secondary,3,57 years,11438,4922,6516
Upper secondary,3,58 years,10948,4679,6269
Upper secondary,3,59 years,10238,4209,6029
Upper secondary,3,60 years,9936,4245,5691
Upper secondary,3,61 years,9616,4087,5529
Upper secondary,3,62 years,8916,3785,5131
Upper secondary,3,63 years,8500,3543,4957
Upper secondary,3,64 years,7656,3168,4488
Upper secondary,3,65 years,7004,2915,4089
Upper secondary,3,66 years,6546,2630,3916
Upper secondary,3,67 years,6108,2509,3599
Upper secondary,3,68 years,5759,2361,3398
Upper secondary,3,69 years,5649,2239,3410
Upper secondary,3,70 years,5282,2074,3208
Upper secondary,3,71 years,4880,1947,2933
Upper secondary,3,72 years,4611,1860,2751
Upper secondary,3,73 years,4258,1627,2631
Upper secondary,3,74 years,3803,1445,2358
Upper secondary,3,75 years,3493,1297,2196
Upper secondary,3,76 years,3323,1170,2153
Upper secondary,3,77 years,3268,1229,2039
Upper secondary,3,78 years,2876,1005,1871
Upper secondary,3,79 years,2708,998,1710
Upper secondary,3,80 years,2553,894,1659
Upper secondary,3,81 years,2335,814,1521
Upper secondary,3,82 years,2056,683,1373
Upper secondary,3,83 years,1855,604,1251
Upper secondary,3,84 years,1701,555,1146
Upper secondary,3,85 years and over,8645,2296,6349
Technical/vocational,2-5,15 years,0,0,0
Technical/vocational,2-5,16 years,53,33,20
Technical/vocational,2-5,17 years,99,54,45
Technical/vocational,2-5,18 years,464,226,238
Technical/vocational,2-5,19 years,1429,674,755
Technical/vocational,2-5,20 years,2466,1082,1384
Technical/vocational,2-5,21 years,3080,1457,1623
Technical/vocational,2-5,22 years,3628,1586,2042
Technical/vocational,2-5,23 years,4008,1844,2164
Technical/vocational,2-5,24 years,4142,1809,2333
Technical/vocational,2-5,25 years,4223,1865,2358
Technical/vocational,2-5,26 years,4069,1653,2416
Technical/vocational,2-5,27 years,4079,1601,2478
Technical/vocational,2-5,28 years,4415,1743,2672
Technical/vocational,2-5,29 years,5009,1909,3100
Technical/vocational,2-5,30 years,5401,2159,3242
Technical/vocational,2-5,31 years,5854,2354,3500
Technical/vocational,2-5,32 years,6049,2542,3507
Technical/vocational,2-5,33 years,6527,2802,3725
Technical/vocational,2-5,34 years,6803,2971,3832
Technical/vocational,2-5,35 years,6996,3066,3930
Technical/vocational,2-5,36 years,7291,3170,4121
Technical/vocational,2-5,37 years,6868,3044,3824
Technical/vocational,2-5,38 years,6845,3022,3823
Technical/vocational,2-5,39 years,6740,3060,3680
Technical/vocational,2-5,40 years,6734,3039,3695
Technical/vocational,2-5,41 years,6801,3014,3787
Technical/vocational,2-5,42 years,6935,2943,3992
Technical/vocational,2-5,43 years,6892,2929,3963
Technical/vocational,2-5,44 years,6696,2835,3861
Technical/vocational,2-5,45 years,6510,2766,3744
Technical/vocational,2-5,46 years,6306,2645,3661
Technical/vocational,2-5,47 years,5908,2509,3399
Technical/vocational,2-5,48 years,5778,2446,3332
Technical/vocational,2-5,49 years,5545,2336,3209
Technical/vocational,2-5,50 years,5315,2263,3052
Technical/vocational,2-5,51 years,5369,2276,3093
Technical/vocational,2-5,52 years,5033,2155,2878
Technical/vocational,2-5,53 years,4932,2179,2753
Technical/vocational,2-5,54 years,4354,2016,2338
Technical/vocational,2-5,55 years,4274,1925,2349
Technical/vocational,2-5,56 years,4155,1892,2263
Technical/vocational,2-5,57 years,4001,1908,2093
Technical/vocational,2-5,58 years,3849,1854,1995
Technical/vocational,2-5,59 years,3674,1899,1775
Technical/vocational,2-5,60 years,3521,1771,1750
Technical/vocational,2-5,61 years,3406,1726,1680
Technical/vocational,2-5,62 years,3327,1802,1525
Technical/vocational,2-5,63 years,3402,1838,1564
Technical/vocational,2-5,64 years,3544,1929,1615
Technical/vocational,2-5,65 years,3328,1861,1467
Technical/vocational,2-5,66 years,3125,1725,1400
Technical/vocational,2-5,67 years,2976,1646,1330
Technical/vocational,2-5,68 years,2847,1577,1270
Technical/vocational,2-5,69 years,2741,1480,1261
Technical/vocational,2-5,70 years,2483,1340,1143
Technical/vocational,2-5,71 years,2185,1205,980
Technical/vocational,2-5,72 years,2051,1118,933
Technical/vocational,2-5,73 years,1881,1004,877
Technical/vocational,2-5,74 years,1693,927,766
Technical/vocational,2-5,75 years,1551,836,715
Technical/vocational,2-5,76 years,1450,796,654
Technical/vocational,2-5,77 years,1341,723,618
Technical/vocational,2-5,78 years,1194,646,548
Technical/vocational,2-5,79 years,1150,578,572
Technical/vocational,2-5,80 years,1027,508,519
Technical/vocational,2-5,81 years,994,478,516
Technical/vocational,2-5,82 years,812,365,447
Technical/vocational,2-5,83 years,646,304,342
Technical/vocational,2-5,84 years,583,258,325
Technical/vocational,2-5,85 years and over,2675,942,1733
Advanced certificate/completed apprenticeship,4,15 years,0,0,0
Advanced certificate/completed apprenticeship,4,16 years,0,0,0
Advanced certificate/completed apprenticeship,4,17 years,59,38,21
Advanced certificate/completed apprenticeship,4,18 years,109,64,45
Advanced certificate/completed apprenticeship,4,19 years,341,186,155
Advanced certificate/completed apprenticeship,4,20 years,857,434,423
Advanced certificate/completed apprenticeship,4,21 years,1384,679,705
Advanced certificate/completed apprenticeship,4,22 years,1726,936,790
Advanced certificate/completed apprenticeship,4,23 years,2035,1121,914
Advanced certificate/completed apprenticeship,4,24 years,2265,1216,1049
Advanced certificate/completed apprenticeship,4,25 years,2800,1617,1183
Advanced certificate/completed apprenticeship,4,26 years,2957,1778,1179
Advanced certificate/completed apprenticeship,4,27 years,3266,2066,1200
Advanced certificate/completed apprenticeship,4,28 years,3715,2446,1269
Advanced certificate/completed apprenticeship,4,29 years,4296,2802,1494
Advanced certificate/completed apprenticeship,4,30 years,4601,3021,1580
Advanced certificate/completed apprenticeship,4,31 years,4931,3283,1648
Advanced certificate/completed apprenticeship,4,32 years,5128,3427,1701
Advanced certificate/completed apprenticeship,4,33 years,5539,3786,1753
Advanced certificate/completed apprenticeship,4,34 years,5744,3961,1783
Advanced certificate/completed apprenticeship,4,35 years,5853,4045,1808
Advanced certificate/completed apprenticeship,4,36 years,5936,4063,1873
Advanced certificate/completed apprenticeship,4,37 years,5518,3730,1788
Advanced certificate/completed apprenticeship,4,38 years,5409,3599,1810
Advanced certificate/completed apprenticeship,4,39 years,5013,3250,1763
Advanced certificate/completed apprenticeship,4,40 years,4826,3076,1750
Advanced certificate/completed apprenticeship,4,41 years,4922,3172,1750
Advanced certificate/completed apprenticeship,4,42 years,4994,3128,1866
Advanced certificate/completed apprenticeship,4,43 years,4816,3069,1747
Advanced certificate/completed apprenticeship,4,44 years,4662,2922,1740
Advanced certificate/completed apprenticeship,4,45 years,4503,2810,1693
Advanced certificate/completed apprenticeship,4,46 years,4331,2716,1615
Advanced certificate/completed apprenticeship,4,47 years,4117,2539,1578
Advanced certificate/completed apprenticeship,4,48 years,3991,2542,1449
Advanced certificate/completed apprenticeship,4,49 years,4062,2569,1493
Advanced certificate/completed apprenticeship,4,50 years,3966,2630,1336
Advanced certificate/completed apprenticeship,4,51 years,4107,2750,1357
Advanced certificate/completed apprenticeship,4,52 years,3789,2549,1240
Advanced certificate/completed apprenticeship,4,53 years,3536,2452,1084
Advanced certificate/completed apprenticeship,4,54 years,3251,2252,999
Advanced certificate/completed apprenticeship,4,55 years,3184,2167,1017
Advanced certificate/completed apprenticeship,4,56 years,2828,1910,918
Advanced certificate/completed apprenticeship,4,57 years,2719,1847,872
Advanced certificate/completed apprenticeship,4,58 years,2573,1789,784
Advanced certificate/completed apprenticeship,4,59 years,2364,1636,728
Advanced certificate/completed apprenticeship,4,60 years,2121,1445,676
Advanced certificate/completed apprenticeship,4,61 years,2048,1448,600
Advanced certificate/completed apprenticeship,4,62 years,1880,1327,553
Advanced certificate/completed apprenticeship,4,63 years,1869,1315,554
Advanced certificate/completed apprenticeship,4,64 years,1708,1242,466
Advanced certificate/completed apprenticeship,4,65 years,1556,1147,409
Advanced certificate/completed apprenticeship,4,66 years,1537,1097,440
Advanced certificate/completed apprenticeship,4,67 years,1414,996,418
Advanced certificate/completed apprenticeship,4,68 years,1262,924,338
Advanced certificate/completed apprenticeship,4,69 years,1140,822,318
Advanced certificate/completed apprenticeship,4,70 years,1016,725,291
Advanced certificate/completed apprenticeship,4,71 years,900,629,271
Advanced certificate/completed apprenticeship,4,72 years,810,535,275
Advanced certificate/completed apprenticeship,4,73 years,680,452,228
Advanced certificate/completed apprenticeship,4,74 years,646,452,194
Advanced certificate/completed apprenticeship,4,75 years,555,372,183
Advanced certificate/completed apprenticeship,4,76 years,512,348,164
Advanced certificate/completed apprenticeship,4,77 years,457,314,143
Advanced certificate/completed apprenticeship,4,78 years,426,279,147
Advanced certificate/completed apprenticeship,4,79 years,369,237,132
Advanced certificate/completed apprenticeship,4,80 years,309,213,96
Advanced certificate/completed apprenticeship,4,81 years,331,229,102
Advanced certificate/completed apprenticeship,4,82 years,286,178,108
Advanced certificate/completed apprenticeship,4,83 years,265,179,86
Advanced certificate/completed apprenticeship,4,84 years,224,123,101
Advanced certificate/completed apprenticeship,4,85 years and over,974,487,487
Higher certificate,5,15 years,0,0,0
Higher certificate,5,16 years,0,0,0
Higher certificate,5,17 years,0,0,0
Higher certificate,5,18 years,129,68,61
Higher certificate,5,19 years,239,96,143
Higher certificate,5,20 years,550,236,314
Higher certificate,5,21 years,916,401,515
Higher certificate,5,22 years,1234,500,734
Higher certificate,5,23 years,1559,713,846
Higher certificate,5,24 years,1770,822,948
Higher certificate,5,25 years,1915,867,1048
Higher certificate,5,26 years,2067,936,1131
Higher certificate,5,27 years,2198,970,1228
Higher certificate,5,28 years,2428,1043,1385
Higher certificate,5,29 years,2735,1193,1542
Higher certificate,5,30 years,2925,1225,1700
Higher certificate,5,31 years,3187,1391,1796
Higher certificate,5,32 years,3406,1448,1958
Higher certificate,5,33 years,3732,1606,2126
Higher certificate,5,34 years,4003,1731,2272
Higher certificate,5,35 years,4264,1924,2340
Higher certificate,5,36 years,4426,2016,2410
Higher certificate,5,37 years,4408,1873,2535
Higher certificate,5,38 years,4433,1937,2496
Higher certificate,5,39 years,4308,1857,2451
Higher certificate,5,40 years,4253,1835,2418
Higher certificate,5,41 years,4346,1823,2523
Higher certificate,5,42 years,4413,1862,2551
Higher certificate,5,43 years,4397,1854,2543
Higher certificate,5,44 years,4397,1872,2525
Higher certificate,5,45 years,4341,1842,2499
Higher certificate,5,46 years,4091,1724,2367
Higher certificate,5,47 years,3969,1702,2267
Higher certificate,5,48 years,3767,1527,2240
Higher certificate,5,49 years,3823,1569,2254
Higher certificate,5,50 years,3711,1546,2165
Higher certificate,5,51 years,3626,1491,2135
Higher certificate,5,52 years,3402,1439,1963
Higher certificate,5,53 years,3210,1410,1800
Higher certificate,5,54 years,3036,1304,1732
Higher certificate,5,55 years,2911,1221,1690
Higher certificate,5,56 years,2869,1236,1633
Higher certificate,5,57 years,2595,1139,1456
Higher certificate,5,58 years,2566,1168,1398
Higher certificate,5,59 years,2234,1028,1206
Higher certificate,5,60 years,2179,961,1218
Higher certificate,5,61 years,2076,920,1156
Higher certificate,5,62 years,1894,805,1089
Higher certificate,5,63 years,1768,837,931
Higher certificate,5,64 years,1548,684,864
Higher certificate,5,65 years,1408,636,772
Higher certificate,5,66 years,1337,619,718
Higher certificate,5,67 years,1267,589,678
Higher certificate,5,68 years,1167,538,629
Higher certificate,5,69 years,1062,529,533
Higher certificate,5,70 years,917,449,468
Higher certificate,5,71 years,844,392,452
Higher certificate,5,72 years,785,369,416
Higher certificate,5,73 years,666,303,363
Higher certificate,5,74 years,628,297,331
Higher certificate,5,75 years,521,235,286
Higher certificate,5,76 years,548,246,302
Higher certificate,5,77 years,443,189,254
Higher certificate,5,78 years,395,169,226
Higher certificate,5,79 years,372,165,207
Higher certificate,5,80 years,369,157,212
Higher certificate,5,81 years,299,110,189
Higher certificate,5,82 years,330,134,196
Higher certificate,5,83 years,258,92,166
Higher certificate,5,84 years,243,94,149
Higher certificate,5,85 years and over,1238,326,912
Ordinary bachelor degree/professional qualification or both,6,15 years,0,0,0
Ordinary bachelor degree/professional qualification or both,6,16 years,0,0,0
Ordinary bachelor degree/professional qualification or both,6,17 years,0,0,0
Ordinary bachelor degree/professional qualification or both,6,18 years,0,0,0
Ordinary bachelor degree/professional qualification or both,6,19 years,91,40,51
Ordinary bachelor degree/professional qualification or both,6,20 years,225,97,128
Ordinary bachelor degree/professional qualification or both,6,21 years,632,294,338
Ordinary bachelor degree/professional qualification or both,6,22 years,1547,682,865
Ordinary bachelor degree/professional qualification or both,6,23 years,2251,1031,1220
Ordinary bachelor degree/professional qualification or both,6,24 years,2696,1286,1410
Ordinary bachelor degree/professional qualification or both,6,25 years,3233,1546,1687
Ordinary bachelor degree/professional qualification or both,6,26 years,3208,1562,1646
Ordinary bachelor degree/professional qualification or both,6,27 years,3417,1612,1805
Ordinary bachelor degree/professional qualification or both,6,28 years,3775,1705,2070
Ordinary bachelor degree/professional qualification or both,6,29 years,4137,1890,2247
Ordinary bachelor degree/professional qualification or both,6,30 years,4684,2050,2634
Ordinary bachelor degree/professional qualification or both,6,31 years,5102,2309,2793
Ordinary bachelor degree/professional qualification or both,6,32 years,5771,2559,3212
Ordinary bachelor degree/professional qualification or both,6,33 years,6381,2811,3570
Ordinary bachelor degree/professional qualification or both,6,34 years,6753,2919,3834
Ordinary bachelor degree/professional qualification or both,6,35 years,7172,3222,3950
Ordinary bachelor degree/professional qualification or both,6,36 years,7373,3353,4020
Ordinary bachelor degree/professional qualification or both,6,37 years,7337,3209,4128
Ordinary bachelor degree/professional qualification or both,6,38 years,7145,3165,3980
Ordinary bachelor degree/professional qualification or both,6,39 years,7169,3240,3929
Ordinary bachelor degree/professional qualification or both,6,40 years,7067,3251,3816
Ordinary bachelor degree/professional qualification or both,6,41 years,7110,3248,3862
Ordinary bachelor degree/professional qualification or both,6,42 years,6848,3119,3729
Ordinary bachelor degree/professional qualification or both,6,43 years,6779,3144,3635
Ordinary bachelor degree/professional qualification or both,6,44 years,6328,2846,3482
Ordinary bachelor degree/professional qualification or both,6,45 years,5927,2706,3221
Ordinary bachelor degree/professional qualification or both,6,46 years,5531,2602,2929
Ordinary bachelor degree/professional qualification or both,6,47 years,5040,2339,2701
Ordinary bachelor degree/professional qualification or both,6,48 years,4911,2214,2697
Ordinary bachelor degree/professional qualification or both,6,49 years,4592,2082,2510
Ordinary bachelor degree/professional qualification or both,6,50 years,4627,2048,2579
Ordinary bachelor degree/professional qualification or both,6,51 years,4536,1946,2590
Ordinary bachelor degree/professional qualification or both,6,52 years,4374,1814,2560
Ordinary bachelor degree/professional qualification or both,6,53 years,4285,1878,2407
Ordinary bachelor degree/professional qualification or both,6,54 years,4131,1811,2320
Ordinary bachelor degree/professional qualification or both,6,55 years,3795,1682,2113
Ordinary bachelor degree/professional qualification or both,6,56 years,3724,1594,2130
Ordinary bachelor degree/professional qualification or both,6,57 years,3534,1563,1971
Ordinary bachelor degree/professional qualification or both,6,58 years,3520,1550,1970
Ordinary bachelor degree/professional qualification or both,6,59 years,3510,1602,1908
Ordinary bachelor degree/professional qualification or both,6,60 years,3323,1524,1799
Ordinary bachelor degree/professional qualification or both,6,61 years,3232,1418,1814
Ordinary bachelor degree/professional qualification or both,6,62 years,3129,1386,1743
Ordinary bachelor degree/professional qualification or both,6,63 years,2980,1376,1604
Ordinary bachelor degree/professional qualification or both,6,64 years,2709,1226,1483
Ordinary bachelor degree/professional qualification or both,6,65 years,2605,1171,1434
Ordinary bachelor degree/professional qualification or both,6,66 years,2427,1107,1320
Ordinary bachelor degree/professional qualification or both,6,67 years,2410,1139,1271
Ordinary bachelor degree/professional qualification or both,6,68 years,2344,1125,1219
Ordinary bachelor degree/professional qualification or both,6,69 years,2068,944,1124
Ordinary bachelor degree/professional qualification or both,6,70 years,1954,892,1062
Ordinary bachelor degree/professional qualification or both,6,71 years,1822,811,1011
Ordinary bachelor degree/professional qualification or both,6,72 years,1603,710,893
Ordinary bachelor degree/professional qualification or both,6,73 years,1459,689,770
Ordinary bachelor degree/professional qualification or both,6,74 years,1263,592,671
Ordinary bachelor degree/professional qualification or both,6,75 years,1188,534,654
Ordinary bachelor degree/professional qualification or both,6,76 years,1171,564,607
Ordinary bachelor degree/professional qualification or both,6,77 years,1155,503,652
Ordinary bachelor degree/professional qualification or both,6,78 years,1031,464,567
Ordinary bachelor degree/professional qualification or both,6,79 years,940,395,545
Ordinary bachelor degree/professional qualification or both,6,80 years,932,426,506
Ordinary bachelor degree/professional qualification or both,6,81 years,811,372,439
Ordinary bachelor degree/professional qualification or both,6,82 years,693,293,400
Ordinary bachelor degree/professional qualification or both,6,83 years,580,253,327
Ordinary bachelor degree/professional qualification or both,6,84 years,591,264,327
Ordinary bachelor degree/professional qualification or both,6,85 years and over,2429,893,1536
Honours bachelor degree/professional qualification or both,6,15 years,0,0,0
Honours bachelor degree/professional qualification or both,6,16 years,0,0,0
Honours bachelor degree/professional qualification or both,6,17 years,0,0,0
Honours bachelor degree/professional qualification or both,6,18 years,0,0,0
Honours bachelor degree/professional qualification or both,6,19 years,84,41,43
Honours bachelor degree/professional qualification or both,6,20 years,122,56,66
Honours bachelor degree/professional qualification or both,6,21 years,910,303,607
Honours bachelor degree/professional qualification or both,6,22 years,4526,1751,2775
Honours bachelor degree/professional qualification or both,6,23 years,9343,3837,5506
Honours bachelor degree/professional qualification or both,6,24 years,10708,4525,6183
Honours bachelor degree/professional qualification or both,6,25 years,11041,4689,6352
Honours bachelor degree/professional qualification or both,6,26 years,10470,4339,6131
Honours bachelor degree/professional qualification or both,6,27 years,10066,4148,5918
Honours bachelor degree/professional qualification or both,6,28 years,10152,4084,6068
Honours bachelor degree/professional qualification or both,6,29 years,10288,4201,6087
Honours bachelor degree/professional qualification or both,6,30 years,10881,4405,6476
Honours bachelor degree/professional qualification or both,6,31 years,11028,4589,6439
Honours bachelor degree/professional qualification or both,6,32 years,11850,4787,7063
Honours bachelor degree/professional qualification or both,6,33 years,11968,4913,7055
Honours bachelor degree/professional qualification or both,6,34 years,11827,4979,6848
Honours bachelor degree/professional qualification or both,6,35 years,11575,4796,6779
Honours bachelor degree/professional qualification or both,6,36 years,11085,4728,6357
Honours bachelor degree/professional qualification or both,6,37 years,10660,4515,6145
Honours bachelor degree/professional qualification or both,6,38 years,10083,4440,5643
Honours bachelor degree/professional qualification or both,6,39 years,9558,4226,5332
Honours bachelor degree/professional qualification or both,6,40 years,9168,4147,5021
Honours bachelor degree/professional qualification or both,6,41 years,8953,4095,4858
Honours bachelor degree/professional qualification or both,6,42 years,8523,3962,4561
Honours bachelor degree/professional qualification or both,6,43 years,7828,3674,4154
Honours bachelor degree/professional qualification or both,6,44 years,7133,3370,3763
Honours bachelor degree/professional qualification or both,6,45 years,6904,3242,3662
Honours bachelor degree/professional qualification or both,6,46 years,6452,3073,3379
Honours bachelor degree/professional qualification or both,6,47 years,5854,2835,3019
Honours bachelor degree/professional qualification or both,6,48 years,5332,2488,2844
Honours bachelor degree/professional qualification or both,6,49 years,5286,2507,2779
Honours bachelor degree/professional qualification or both,6,50 years,5027,2372,2655
Honours bachelor degree/professional qualification or both,6,51 years,4967,2248,2719
Honours bachelor degree/professional qualification or both,6,52 years,4620,2071,2549
Honours bachelor degree/professional qualification or both,6,53 years,4293,1995,2298
Honours bachelor degree/professional qualification or both,6,54 years,3970,1866,2104
Honours bachelor degree/professional qualification or both,6,55 years,3810,1731,2079
Honours bachelor degree/professional qualification or both,6,56 years,3486,1589,1897
Honours bachelor degree/professional qualification or both,6,57 years,3358,1629,1729
Honours bachelor degree/professional qualification or both,6,58 years,3228,1550,1678
Honours bachelor degree/professional qualification or both,6,59 years,3015,1539,1476
Honours bachelor degree/professional qualification or both,6,60 years,2739,1379,1360
Honours bachelor degree/professional qualification or both,6,61 years,2616,1341,1275
Honours bachelor degree/professional qualification or both,6,62 years,2404,1290,1114
Honours bachelor degree/professional qualification or both,6,63 years,2266,1216,1050
Honours bachelor degree/professional qualification or both,6,64 years,2087,1139,948
Honours bachelor degree/professional qualification or both,6,65 years,1816,972,844
Honours bachelor degree/professional qualification or both,6,66 years,1681,896,785
Honours bachelor degree/professional qualification or both,6,67 years,1625,912,713
Honours bachelor degree/professional qualification or both,6,68 years,1441,843,598
Honours bachelor degree/professional qualification or both,6,69 years,1457,831,626
Honours bachelor degree/professional qualification or both,6,70 years,1221,720,501
Honours bachelor degree/professional qualification or both,6,71 years,1174,666,508
Honours bachelor degree/professional qualification or both,6,72 years,954,519,435
Honours bachelor degree/professional qualification or both,6,73 years,923,501,422
Honours bachelor degree/professional qualification or both,6,74 years,813,447,366
Honours bachelor degree/professional qualification or both,6,75 years,692,386,306
Honours bachelor degree/professional qualification or both,6,76 years,679,365,314
Honours bachelor degree/professional qualification or both,6,77 years,596,310,286
Honours bachelor degree/professional qualification or both,6,78 years,584,329,255
Honours bachelor degree/professional qualification or both,6,79 years,489,277,212
Honours bachelor degree/professional qualification or both,6,80 years,449,251,198
Honours bachelor degree/professional qualification or both,6,81 years,441,242,199
Honours bachelor degree/professional qualification or both,6,82 years,429,233,196
Honours bachelor degree/professional qualification or both,6,83 years,350,175,175
Honours bachelor degree/professional qualification or both,6,84 years,298,154,144
Honours bachelor degree/professional qualification or both,6,85 years and over,1637,731,906
Postgraduate diploma or degree,7,15 years,0,0,0
Postgraduate diploma or degree,7,16 years,0,0,0
Postgraduate diploma or degree,7,17 years,0,0,0
Postgraduate diploma or degree,7,18 years,0,0,0
Postgraduate diploma or degree,7,19 years,0,0,0
Postgraduate diploma or degree,7,20 years,57,29,28
Postgraduate diploma or degree,7,21 years,86,36,50
Postgraduate diploma or degree,7,22 years,421,180,241
Postgraduate diploma or degree,7,23 years,1639,723,916
Postgraduate diploma or degree,7,24 years,3514,1524,1990
Postgraduate diploma or degree,7,25 years,4730,2057,2673
Postgraduate diploma or degree,7,26 years,5618,2347,3271
Postgraduate diploma or degree,7,27 years,6305,2615,3690
Postgraduate diploma or degree,7,28 years,7159,2764,4395
Postgraduate diploma or degree,7,29 years,7707,3035,4672
Postgraduate diploma or degree,7,30 years,8082,2998,5084
Postgraduate diploma or degree,7,31 years,8339,3071,5268
Postgraduate diploma or degree,7,32 years,8961,3213,5748
Postgraduate diploma or degree,7,33 years,9838,3436,6402
Postgraduate diploma or degree,7,34 years,10328,3765,6563
Postgraduate diploma or degree,7,35 years,10887,3939,6948
Postgraduate diploma or degree,7,36 years,10669,4055,6614
Postgraduate diploma or degree,7,37 years,10481,3909,6572
Postgraduate diploma or degree,7,38 years,9958,3800,6158
Postgraduate diploma or degree,7,39 years,9769,3810,5959
Postgraduate diploma or degree,7,40 years,9458,3774,5684
Postgraduate diploma or degree,7,41 years,8957,3652,5305
Postgraduate diploma or degree,7,42 years,8694,3659,5035
Postgraduate diploma or degree,7,43 years,8335,3611,4724
Postgraduate diploma or degree,7,44 years,7687,3389,4298
Postgraduate diploma or degree,7,45 years,7138,3254,3884
Postgraduate diploma or degree,7,46 years,6720,3062,3658
Postgraduate diploma or degree,7,47 years,6106,2862,3244
Postgraduate diploma or degree,7,48 years,5761,2571,3190
Postgraduate diploma or degree,7,49 years,5469,2480,2989
Postgraduate diploma or degree,7,50 years,5064,2249,2815
Postgraduate diploma or degree,7,51 years,4864,2222,2642
Postgraduate diploma or degree,7,52 years,4689,2120,2569
Postgraduate diploma or degree,7,53 years,4336,1995,2341
Postgraduate diploma or degree,7,54 years,4020,1872,2148
Postgraduate diploma or degree,7,55 years,3944,1873,2071
Postgraduate diploma or degree,7,56 years,3785,1705,2080
Postgraduate diploma or degree,7,57 years,3597,1713,1884
Postgraduate diploma or degree,7,58 years,3383,1473,1910
Postgraduate diploma or degree,7,59 years,3276,1553,1723
Postgraduate diploma or degree,7,60 years,3055,1407,1648
Postgraduate diploma or degree,7,61 years,2776,1366,1410
Postgraduate diploma or degree,7,62 years,2638,1263,1375
Postgraduate diploma or degree,7,63 years,2559,1204,1355
Postgraduate diploma or degree,7,64 years,2287,1084,1203
Postgraduate diploma or degree,7,65 years,2130,1039,1091
Postgraduate diploma or degree,7,66 years,1932,943,989
Postgraduate diploma or degree,7,67 years,1809,921,888
Postgraduate diploma or degree,7,68 years,1770,927,843
Postgraduate diploma or degree,7,69 years,1692,898,794
Postgraduate diploma or degree,7,70 years,1497,763,734
Postgraduate diploma or degree,7,71 years,1328,706,622
Postgraduate diploma or degree,7,72 years,1215,663,552
Postgraduate diploma or degree,7,73 years,1001,569,432
Postgraduate diploma or degree,7,74 years,859,488,371
Postgraduate diploma or degree,7,75 years,725,378,347
Postgraduate diploma or degree,7,76 years,645,367,278
Postgraduate diploma or degree,7,77 years,648,346,302
Postgraduate diploma or degree,7,78 years,539,296,243
Postgraduate diploma or degree,7,79 years,504,302,202
Postgraduate diploma or degree,7,80 years,405,213,192
Postgraduate diploma or degree,7,81 years,388,216,172
Postgraduate diploma or degree,7,82 years,337,169,168
Postgraduate diploma or degree,7,83 years,251,138,113
Postgraduate diploma or degree,7,84 years,233,126,107
Postgraduate diploma or degree,7,85 years and over,1053,489,564
Doctorate (Ph.D.),8,15 years,0,0,0
Doctorate (Ph.D.),8,16 years,0,0,0
Doctorate (Ph.D.),8,17 years,0,0,0
Doctorate (Ph.D.),8,18 years,0,0,0
Doctorate (Ph.D.),8,19 years,0,0,0
Doctorate (Ph.D.),8,20 years,6,5,1
Doctorate (Ph.D.),8,21 years,11,5,6
Doctorate (Ph.D.),8,22 years,4,2,2
Doctorate (Ph.D.),8,23 years,10,6,4
Doctorate (Ph.D.),8,24 years,30,14,16
Doctorate (Ph.D.),8,25 years,67,27,40
Doctorate (Ph.D.),8,26 years,152,69,83
Doctorate (Ph.D.),8,27 years,320,150,170
Doctorate (Ph.D.),8,28 years,448,226,222
Doctorate (Ph.D.),8,29 years,601,283,318
Doctorate (Ph.D.),8,30 years,677,321,356
Doctorate (Ph.D.),8,31 years,719,343,376
Doctorate (Ph.D.),8,32 years,814,384,430
Doctorate (Ph.D.),8,33 years,798,363,435
Doctorate (Ph.D.),8,34 years,837,398,439
Doctorate (Ph.D.),8,35 years,904,450,454
Doctorate (Ph.D.),8,36 years,974,461,513
Doctorate (Ph.D.),8,37 years,920,424,496
Doctorate (Ph.D.),8,38 years,914,403,511
Doctorate (Ph.D.),8,39 years,862,405,457
Doctorate (Ph.D.),8,40 years,856,423,433
Doctorate (Ph.D.),8,41 years,805,395,410
Doctorate (Ph.D.),8,42 years,830,398,432
Doctorate (Ph.D.),8,43 years,840,437,403
Doctorate (Ph.D.),8,44 years,777,375,402
Doctorate (Ph.D.),8,45 years,802,418,384
Doctorate (Ph.D.),8,46 years,790,414,376
Doctorate (Ph.D.),8,47 years,756,409,347
Doctorate (Ph.D.),8,48 years,776,469,307
Doctorate (Ph.D.),8,49 years,646,351,295
Doctorate (Ph.D.),8,50 years,648,382,266
Doctorate (Ph.D.),8,51 years,632,362,270
Doctorate (Ph.D.),8,52 years,577,343,234
Doctorate (Ph.D.),8,53 years,503,305,198
Doctorate (Ph.D.),8,54 years,488,285,203
Doctorate (Ph.D.),8,55 years,510,298,212
Doctorate (Ph.D.),8,56 years,469,275,194
Doctorate (Ph.D.),8,57 years,470,302,168
Doctorate (Ph.D.),8,58 years,406,246,160
Doctorate (Ph.D.),8,59 years,389,235,154
Doctorate (Ph.D.),8,60 years,378,243,135
Doctorate (Ph.D.),8,61 years,376,236,140
Doctorate (Ph.D.),8,62 years,351,220,131
Doctorate (Ph.D.),8,63 years,323,212,111
Doctorate (Ph.D.),8,64 years,296,214,82
Doctorate (Ph.D.),8,65 years,288,198,90
Doctorate (Ph.D.),8,66 years,266,196,70
Doctorate (Ph.D.),8,67 years,309,213,96
Doctorate (Ph.D.),8,68 years,271,201,70
Doctorate (Ph.D.),8,69 years,265,193,72
Doctorate (Ph.D.),8,70 years,256,201,55
Doctorate (Ph.D.),8,71 years,279,213,66
Doctorate (Ph.D.),8,72 years,260,209,51
Doctorate (Ph.D.),8,73 years,217,169,48
Doctorate (Ph.D.),8,74 years,198,148,50
Doctorate (Ph.D.),8,75 years,180,147,33
Doctorate (Ph.D.),8,76 years,173,143,30
Doctorate (Ph.D.),8,77 years,132,108,24
Doctorate (Ph.D.),8,78 years,108,86,22
Doctorate (Ph.D.),8,79 years,115,88,27
Doctorate (Ph.D.),8,80 years,103,84,19
Doctorate (Ph.D.),8,81 years,91,76,15
Doctorate (Ph.D.),8,82 years,83,66,17
Doctorate (Ph.D.),8,83 years,73,57,16
Doctorate (Ph.D.),8,84 years,55,41,14
Doctorate (Ph.D.),8,85 years and over,275,193,82
Not stated,Unknown,15 years,308,165,143
Not stated,Unknown,16 years,325,165,160
Not stated,Unknown,17 years,448,260,188
Not stated,Unknown,18 years,1586,872,714
Not stated,Unknown,19 years,1211,691,520
Not stated,Unknown,20 years,1866,1002,864
Not stated,Unknown,21 years,1734,964,770
Not stated,Unknown,22 years,1786,979,807
Not stated,Unknown,23 years,1880,1042,838
Not stated,Unknown,24 years,2064,1028,1036
Not stated,Unknown,25 years,3195,1746,1449
Not stated,Unknown,26 years,2897,1568,1329
Not stated,Unknown,27 years,8047,4213,3834
Not stated,Unknown,28 years,2767,1479,1288
Not stated,Unknown,29 years,2754,1465,1289
Not stated,Unknown,30 years,5373,3029,2344
Not stated,Unknown,31 years,3063,1655,1408
Not stated,Unknown,32 years,3150,1692,1458
Not stated,Unknown,33 years,3135,1741,1394
Not stated,Unknown,34 years,2989,1627,1362
Not stated,Unknown,35 years,4577,2597,1980
Not stated,Unknown,36 years,5969,3227,2742
Not stated,Unknown,37 years,2830,1557,1273
Not stated,Unknown,38 years,2904,1628,1276
Not stated,Unknown,39 years,2622,1460,1162
Not stated,Unknown,40 years,4215,2366,1849
Not stated,Unknown,41 years,2687,1482,1205
Not stated,Unknown,42 years,2558,1410,1148
Not stated,Unknown,43 years,2539,1342,1197
Not stated,Unknown,44 years,2437,1276,1161
Not stated,Unknown,45 years,4569,2466,2103
Not stated,Unknown,46 years,2904,1584,1320
Not stated,Unknown,47 years,2278,1211,1067
Not stated,Unknown,48 years,2386,1314,1072
Not stated,Unknown,49 years,2268,1209,1059
Not stated,Unknown,50 years,3179,1717,1462
Not stated,Unknown,51 years,2480,1282,1198
Not stated,Unknown,52 years,2346,1206,1140
Not stated,Unknown,53 years,2334,1167,1167
Not stated,Unknown,54 years,2256,1096,1160
Not stated,Unknown,55 years,2704,1404,1300
Not stated,Unknown,56 years,2537,1285,1252
Not stated,Unknown,57 years,3634,1834,1800
Not stated,Unknown,58 years,2401,1160,1241
Not stated,Unknown,59 years,2411,1192,1219
Not stated,Unknown,60 years,2892,1444,1448
Not stated,Unknown,61 years,2648,1242,1406
Not stated,Unknown,62 years,2601,1222,1379
Not stated,Unknown,63 years,2697,1222,1475
Not stated,Unknown,64 years,2738,1255,1483
Not stated,Unknown,65 years,3071,1492,1579
Not stated,Unknown,66 years,3381,1554,1827
Not stated,Unknown,67 years,3219,1503,1716
Not stated,Unknown,68 years,3339,1506,1833
Not stated,Unknown,69 years,3227,1534,1693
Not stated,Unknown,70 years,3318,1578,1740
Not stated,Unknown,71 years,3177,1425,1752
Not stated,Unknown,72 years,3000,1383,1617
Not stated,Unknown,73 years,2845,1293,1552
Not stated,Unknown,74 years,2633,1238,1395
Not stated,Unknown,75 years,2696,1195,1501
Not stated,Unknown,76 years,2498,1121,1377
Not stated,Unknown,77 years,2286,1042,1244
Not stated,Unknown,78 years,2140,949,1191
Not stated,Unknown,79 years,2078,920,1158
Not stated,Unknown,80 years,2149,907,1242
Not stated,Unknown,81 years,1949,816,1133
Not stated,Unknown,82 years,1743,704,1039
Not stated,Unknown,83 years,1631,679,952
Not stated,Unknown,84 years,1456,563,893
Not stated,Unknown,85 years and over,8653,2780,5873
"Economic status - total at school, university, etc.",NA,15 years,60811,31019,29792
"Economic status - total at school, university, etc.",NA,16 years,59158,30123,29035
"Economic status - total at school, university, etc.",NA,17 years,57598,29301,28297
"Economic status - total at school, university, etc.",NA,18 years,49966,24801,25165
"Economic status - total at school, university, etc.",NA,19 years,39276,18806,20470
"Economic status - total at school, university, etc.",NA,20 years,34394,16171,18223
"Economic status - total at school, university, etc.",NA,21 years,29156,13621,15535
"Economic status - total at school, university, etc.",NA,22 years,22063,10787,11276
"Economic status - total at school, university, etc.",NA,23 years,13343,6815,6528
"Economic status - total at school, university, etc.",NA,24 years,9023,4574,4449
"Economic status - total at school, university, etc.",NA,25 years,6667,3406,3261
"Economic status - total at school, university, etc.",NA,26 years,5257,2718,2539
"Economic status - total at school, university, etc.",NA,27 years,4365,2190,2175
"Economic status - total at school, university, etc.",NA,28 years,3638,1840,1798
"Economic status - total at school, university, etc.",NA,29 years,3024,1479,1545
"Economic status - total at school, university, etc.",NA,30 years,2745,1363,1382
"Economic status - total at school, university, etc.",NA,31 years,2297,1108,1189
"Economic status - total at school, university, etc.",NA,32 years,2068,973,1095
"Economic status - total at school, university, etc.",NA,33 years,1930,923,1007
"Economic status - total at school, university, etc.",NA,34 years,1815,860,955
"Economic status - total at school, university, etc.",NA,35 years,1557,733,824
"Economic status - total at school, university, etc.",NA,36 years,1473,684,789
"Economic status - total at school, university, etc.",NA,37 years,1398,643,755
"Economic status - total at school, university, etc.",NA,38 years,1164,569,595
"Economic status - total at school, university, etc.",NA,39 years,1147,542,605
"Economic status - total at school, university, etc.",NA,40 years,1036,487,549
"Economic status - total at school, university, etc.",NA,41 years,920,427,493
"Economic status - total at school, university, etc.",NA,42 years,864,368,496
"Economic status - total at school, university, etc.",NA,43 years,890,360,530
"Economic status - total at school, university, etc.",NA,44 years,815,344,471
"Economic status - total at school, university, etc.",NA,45 years,753,322,431
"Economic status - total at school, university, etc.",NA,46 years,701,296,405
"Economic status - total at school, university, etc.",NA,47 years,648,264,384
"Economic status - total at school, university, etc.",NA,48 years,581,234,347
"Economic status - total at school, university, etc.",NA,49 years,578,224,354
"Economic status - total at school, university, etc.",NA,50 years,515,211,304
"Economic status - total at school, university, etc.",NA,51 years,445,184,261
"Economic status - total at school, university, etc.",NA,52 years,374,166,208
"Economic status - total at school, university, etc.",NA,53 years,399,156,243
"Economic status - total at school, university, etc.",NA,54 years,335,131,204
"Economic status - total at school, university, etc.",NA,55 years,301,116,185
"Economic status - total at school, university, etc.",NA,56 years,261,97,164
"Economic status - total at school, university, etc.",NA,57 years,246,99,147
"Economic status - total at school, university, etc.",NA,58 years,186,73,113
"Economic status - total at school, university, etc.",NA,59 years,148,57,91
"Economic status - total at school, university, etc.",NA,60 years,159,65,94
"Economic status - total at school, university, etc.",NA,61 years,126,68,58
"Economic status - total at school, university, etc.",NA,62 years,78,35,43
"Economic status - total at school, university, etc.",NA,63 years,78,34,44
"Economic status - total at school, university, etc.",NA,64 years,69,36,33
"Economic status - total at school, university, etc.",NA,65 years,36,17,19
"Economic status - total at school, university, etc.",NA,66 years,39,13,26
"Economic status - total at school, university, etc.",NA,67 years,31,16,15
"Economic status - total at school, university, etc.",NA,68 years,28,18,10
"Economic status - total at school, university, etc.",NA,69 years,35,14,21
"Economic status - total at school, university, etc.",NA,70 years,37,21,16
"Economic status - total at school, university, etc.",NA,71 years,38,22,16
"Economic status - total at school, university, etc.",NA,72 years,22,16,6
"Economic status - total at school, university, etc.",NA,73 years,10,3,7
"Economic status - total at school, university, etc.",NA,74 years,13,11,2
"Economic status - total at school, university, etc.",NA,75 years,0,0,0
"Economic status - total at school, university, etc.",NA,76 years,0,0,0
"Economic status - total at school, university, etc.",NA,77 years,0,0,0
"Economic status - total at school, university, etc.",NA,78 years,0,0,0
"Economic status - total at school, university, etc.",NA,79 years,0,0,0
"Economic status - total at school, university, etc.",NA,80 years,0,0,0
"Economic status - total at school, university, etc.",NA,81 years,0,0,0
"Economic status - total at school, university, etc.",NA,82 years,0,0,0
"Economic status - total at school, university, etc.",NA,83 years,0,0,0
"Economic status - total at school, university, etc.",NA,84 years,0,0,0
"Economic status - total at school, university, etc.",NA,85 years and over,0,0,0
Economic status - other,NA,15 years,273,139,134
Economic status - other,NA,16 years,590,306,284
Economic status - other,NA,17 years,1032,560,472
Economic status - other,NA,18 years,2492,1277,1215
Economic status - other,NA,19 years,4045,2078,1967
Economic status - other,NA,20 years,4223,2295,1928
Economic status - other,NA,21 years,4765,2495,2270
Economic status - other,NA,22 years,5533,2743,2790
Economic status - other,NA,23 years,5839,2850,2989
Economic status - other,NA,24 years,5983,2880,3103
Economic status - other,NA,25 years,6305,3018,3287
Economic status - other,NA,26 years,6421,3032,3389
Economic status - other,NA,27 years,6381,3048,3333
Economic status - other,NA,28 years,6834,3197,3637
Economic status - other,NA,29 years,7270,3384,3886
Economic status - other,NA,30 years,7628,3632,3996
Economic status - other,NA,31 years,7810,3778,4032
Economic status - other,NA,32 years,7975,3818,4157
Economic status - other,NA,33 years,8369,4073,4296
Economic status - other,NA,34 years,8308,4086,4222
Economic status - other,NA,35 years,8332,4190,4142
Economic status - other,NA,36 years,8044,4043,4001
Economic status - other,NA,37 years,7312,3733,3579
Economic status - other,NA,38 years,6675,3385,3290
Economic status - other,NA,39 years,6438,3291,3147
Economic status - other,NA,40 years,5946,3039,2907
Economic status - other,NA,41 years,5616,2898,2718
Economic status - other,NA,42 years,5217,2695,2522
Economic status - other,NA,43 years,5087,2627,2460
Economic status - other,NA,44 years,4651,2394,2257
Economic status - other,NA,45 years,4337,2258,2079
Economic status - other,NA,46 years,4080,2141,1939
Economic status - other,NA,47 years,3761,1954,1807
Economic status - other,NA,48 years,3410,1682,1728
Economic status - other,NA,49 years,3223,1627,1596
Economic status - other,NA,50 years,3007,1538,1469
Economic status - other,NA,51 years,2911,1470,1441
Economic status - other,NA,52 years,2703,1380,1323
Economic status - other,NA,53 years,2509,1280,1229
Economic status - other,NA,54 years,2345,1164,1181
Economic status - other,NA,55 years,2301,1163,1138
Economic status - other,NA,56 years,2132,1041,1091
Economic status - other,NA,57 years,1945,989,956
Economic status - other,NA,58 years,1808,859,949
Economic status - other,NA,59 years,1716,830,886
Economic status - other,NA,60 years,1566,762,804
Economic status - other,NA,61 years,1405,718,687
Economic status - other,NA,62 years,1284,693,591
Economic status - other,NA,63 years,1199,628,571
Economic status - other,NA,64 years,1090,524,566
Economic status - other,NA,65 years,988,532,456
Economic status - other,NA,66 years,917,467,450
Economic status - other,NA,67 years,872,427,445
Economic status - other,NA,68 years,804,424,380
Economic status - other,NA,69 years,763,366,397
Economic status - other,NA,70 years,651,340,311
Economic status - other,NA,71 years,577,295,282
Economic status - other,NA,72 years,521,259,262
Economic status - other,NA,73 years,507,268,239
Economic status - other,NA,74 years,457,243,214
Economic status - other,NA,75 years,426,219,207
Economic status - other,NA,76 years,365,177,188
Economic status - other,NA,77 years,358,166,192
Economic status - other,NA,78 years,355,154,201
Economic status - other,NA,79 years,306,132,174
Economic status - other,NA,80 years,306,139,167
Economic status - other,NA,81 years,237,107,130
Economic status - other,NA,82 years,208,91,117
Economic status - other,NA,83 years,209,97,112
Economic status - other,NA,84 years,195,75,120
Economic status - other,NA,85 years and over,985,348,637
